

B+++N+++N
+   +   +
+   +   +
+   +   +
N+++N+++N
+   +   +
+   +   +
+   +   +
N+++N+++R